NO   north.xpm
SO south.xpm
EA east.xpm
WE west.xpm

F 0,0,0
C 0,0,0


11111
1S001
10001
11111
