NO textures/test/north.xpm
SO textures/test/south.xpm
WE textures/test/west.xpm
EA textures/test/east.xpm

F 164,169,20
C 153,204,255

1111111111111111111
1000000000000000001
1000000000000000001
1000000100000000001
1000000000000000001
1000000000000000001
1000000000100000001
1000000000000000001
10000000000000000S1
1111111111111111111